###########################################################################################
#@                                                                                        #
#                                                                                         #
#                                                                                         #
#                                                                                         #
#                                                                                         #
#                                                                                         #
#                                                                                         #
#                                                                                         #
#                                                                                         #
#                                                                                         #
#                                                                                         #
#                                                                                         #
#                                                                                         #
#                                                                                         #
#                                                                                         #
#                                                                                      $. #
#                                                                                         #
#                                                                                         #
#                                                                                         #
#                                                                                         #
###########################################################################################