 ######
 #  . #
##$$  #
#.* *@#
#######