##########
#        #
# $$..   #
# $.$.  @#
#        #
##########