#####
# ..#
# $ #
#.$$#
###@#
  ###