##########
#        #
#  $     #
#    .   #
#     @  #
#        #
##########
