#####
#.$@#
#.  #
#$  #
#   #
#####
