######
#.$@ #
#  $ #
##.  #
 #####
