#####
#   ##
#  $@#
# $ .#
#   .#
######