########
# .... #
# $  $ #
##@## ####
 ###     #
 #     $ #
 #   ##$ #
 ######  #
      ####