        ########
        #     @#
        # $#$ ##
        # $  $#
        ##$ $ #
######### $ # ###
#....  ## $  $  #
# ...    $  $   #
#....  ##########
########